111111111111111111111
1P000C000000000C00001
100111111101111011101
1000000000000000N0001
111101111111011110111
100001000000000101001
101111011111101101101
1000000000N00000000E1
101111101111101011011
100000000000000000001
100011101111101111101
1000N0000000000000001
101111111111111011101
100000000000000000N01
100001111101111111101
100000000000000000001
101011101111101110101
100000000000000000001
101000001010000001101
111111111111111111111
