1111111111111111111111111111111111
1E000000N000000C0000N0000000000001
1010010100100000101001000000010101
101N01001Q101010N1001001000010N101
1P0000000C00C000000000000C000000C1
1111111111111111111111111111111111